#   #   #
# ##### #
#  #* # #
#       #
#########
